{
    "Near regions - overworld": {
        "dimension": "overworld",
        "xmin": -15000,
        "xmax": 12000,
        "zmin": -14000,
        "zmax": 15000,
        "zoom": 3,
        "files": [
            "2023-12-19",
            "2023-12-20",
            "2023-12-21",
            "2023-12-22",
            "2023-12-23",
            "2023-12-24",
            "2023-12-25",
            "2023-12-26",
            "2023-12-27",
            "2023-12-29",
            "2023-12-30",
            "2023-12-31",
            "2024-01-01",
            "2024-01-02",
            "2024-01-03",
            "2024-01-04",
            "2024-01-05",
            "2024-01-06",
            "2024-01-07",
            "2024-01-08",
            "2024-01-09",
            "2024-01-10",
            "2024-01-11",
            "2024-01-12",
            "2024-01-13",
            "2024-01-14",
            "2024-01-15",
            "2024-01-16",
            "2024-01-17",
            "2024-01-18"
        ]
    },
    "Near regions - the_nether": {
        "dimension": "the_nether",
        "xmin": -8192,
        "xmax": 8192,
        "zmin": -8192,
        "zmax": 8192,
        "zoom": 3,
        "files": [
            "2023-12-19",
            "2023-12-20",
            "2023-12-21",
            "2023-12-22",
            "2023-12-23",
            "2023-12-24",
            "2023-12-25",
            "2023-12-26",
            "2023-12-27",
            "2023-12-29",
            "2023-12-30",
            "2023-12-31",
            "2024-01-01",
            "2024-01-02",
            "2024-01-03",
            "2024-01-04",
            "2024-01-05",
            "2024-01-06",
            "2024-01-07",
            "2024-01-08",
            "2024-01-09",
            "2024-01-10",
            "2024-01-11",
            "2024-01-12",
            "2024-01-13",
            "2024-01-14",
            "2024-01-15",
            "2024-01-16",
            "2024-01-17",
            "2024-01-18"
        ]
    },
    "Near regions - the_end": {
        "dimension": "the_end",
        "xmin": -8192,
        "xmax": 8192,
        "zmin": -8192,
        "zmax": 8192,
        "zoom": 3,
        "files": [
            "2023-12-19",
            "2023-12-20",
            "2023-12-21",
            "2023-12-22",
            "2023-12-23",
            "2023-12-24",
            "2023-12-25",
            "2023-12-26",
            "2023-12-27",
            "2023-12-29",
            "2023-12-30",
            "2023-12-31",
            "2024-01-01",
            "2024-01-02",
            "2024-01-03",
            "2024-01-04",
            "2024-01-05",
            "2024-01-06",
            "2024-01-07",
            "2024-01-08",
            "2024-01-09",
            "2024-01-10",
            "2024-01-11",
            "2024-01-12",
            "2024-01-13",
            "2024-01-14",
            "2024-01-15",
            "2024-01-16",
            "2024-01-17",
            "2024-01-18"
        ]
    }
}