{
    "Near regions - overworld": {
        "dimension": "overworld",
        "xmin": -15000,
        "xmax": 12000,
        "zmin": -14000,
        "zmax": 15000,
        "zoom": 3,
        "files": [
            "2023-12-19",
            "2023-12-20",
            "2023-12-21",
            "2023-12-22",
            "2023-12-23",
            "2023-12-24",
            "2023-12-25",
            "2023-12-26",
            "2023-12-27",
            "2023-12-29",
            "2023-12-30",
            "2023-12-31",
            "2024-01-01",
            "2024-01-02",
            "2024-01-03",
            "2024-01-04",
            "2024-01-05",
            "2024-01-06",
            "2024-01-07",
            "2024-01-08",
            "2024-01-09",
            "2024-01-10",
            "2024-01-11",
            "2024-01-12",
            "2024-01-13",
            "2024-01-14",
            "2024-01-15",
            "2024-01-16",
            "2024-01-17",
            "2024-01-18",
            "2024-01-19",
            "2024-01-20",
            "2024-01-21",
            "2024-01-22",
            "2024-01-23",
            "2024-01-24",
            "2024-01-25",
            "2024-01-26",
            "2024-01-27",
            "2024-01-28",
            "2024-01-29",
            "2024-01-30",
            "2024-01-31",
            "2024-02-01",
            "2024-02-02",
            "2024-02-03",
            "2024-02-04",
            "2024-02-05",
            "2024-02-06",
            "2024-02-07",
            "2024-02-08",
            "2024-02-09",
            "2024-02-10",
            "2024-02-11",
            "2024-02-12",
            "2024-02-13",
            "2024-02-14",
            "2024-02-15",
            "2024-02-16",
            "2024-02-17",
            "2024-02-18",
            "2024-02-19",
            "2024-02-20",
            "2024-02-21",
            "2024-02-22",
            "2024-02-23",
            "2024-02-24",
            "2024-02-25",
            "2024-02-26",
            "2024-02-27",
            "2024-02-28",
            "2024-02-29",
            "2024-03-01",
            "2024-03-02",
            "2024-03-03",
            "2024-03-04"
        ]
    },
    "Near regions - the_nether": {
        "dimension": "the_nether",
        "xmin": -8192,
        "xmax": 8192,
        "zmin": -8192,
        "zmax": 8192,
        "zoom": 3,
        "files": [
            "2023-12-19",
            "2023-12-20",
            "2023-12-21",
            "2023-12-22",
            "2023-12-23",
            "2023-12-24",
            "2023-12-25",
            "2023-12-26",
            "2023-12-27",
            "2023-12-29",
            "2023-12-30",
            "2023-12-31",
            "2024-01-01",
            "2024-01-02",
            "2024-01-03",
            "2024-01-04",
            "2024-01-05",
            "2024-01-06",
            "2024-01-07",
            "2024-01-08",
            "2024-01-09",
            "2024-01-10",
            "2024-01-11",
            "2024-01-12",
            "2024-01-13",
            "2024-01-14",
            "2024-01-15",
            "2024-01-16",
            "2024-01-17",
            "2024-01-18",
            "2024-01-19",
            "2024-01-20",
            "2024-01-21",
            "2024-01-22",
            "2024-01-23",
            "2024-01-24",
            "2024-01-25",
            "2024-01-26",
            "2024-01-27",
            "2024-01-28",
            "2024-01-29",
            "2024-01-30",
            "2024-01-31",
            "2024-02-01",
            "2024-02-02",
            "2024-02-03",
            "2024-02-04",
            "2024-02-05",
            "2024-02-06",
            "2024-02-07",
            "2024-02-08",
            "2024-02-09",
            "2024-02-10",
            "2024-02-11",
            "2024-02-12",
            "2024-02-13",
            "2024-02-14",
            "2024-02-15",
            "2024-02-16",
            "2024-02-17",
            "2024-02-18",
            "2024-02-19",
            "2024-02-20",
            "2024-02-21",
            "2024-02-22",
            "2024-02-23",
            "2024-02-24",
            "2024-02-25",
            "2024-02-26",
            "2024-02-27",
            "2024-02-28",
            "2024-02-29",
            "2024-03-01",
            "2024-03-02",
            "2024-03-03",
            "2024-03-04"
        ]
    },
    "Near regions - the_end": {
        "dimension": "the_end",
        "xmin": -8192,
        "xmax": 8192,
        "zmin": -8192,
        "zmax": 8192,
        "zoom": 3,
        "files": [
            "2023-12-19",
            "2023-12-20",
            "2023-12-21",
            "2023-12-22",
            "2023-12-23",
            "2023-12-24",
            "2023-12-25",
            "2023-12-26",
            "2023-12-27",
            "2023-12-29",
            "2023-12-30",
            "2023-12-31",
            "2024-01-01",
            "2024-01-02",
            "2024-01-03",
            "2024-01-04",
            "2024-01-05",
            "2024-01-06",
            "2024-01-07",
            "2024-01-08",
            "2024-01-09",
            "2024-01-10",
            "2024-01-11",
            "2024-01-12",
            "2024-01-13",
            "2024-01-14",
            "2024-01-15",
            "2024-01-16",
            "2024-01-17",
            "2024-01-18",
            "2024-01-19",
            "2024-01-20",
            "2024-01-21",
            "2024-01-22",
            "2024-01-23",
            "2024-01-24",
            "2024-01-25",
            "2024-01-26",
            "2024-01-27",
            "2024-01-28",
            "2024-01-29",
            "2024-01-30",
            "2024-01-31",
            "2024-02-01",
            "2024-02-02",
            "2024-02-03",
            "2024-02-04",
            "2024-02-05",
            "2024-02-06",
            "2024-02-07",
            "2024-02-08",
            "2024-02-09",
            "2024-02-10",
            "2024-02-11",
            "2024-02-12",
            "2024-02-13",
            "2024-02-14",
            "2024-02-15",
            "2024-02-16",
            "2024-02-17",
            "2024-02-18",
            "2024-02-19",
            "2024-02-20",
            "2024-02-21",
            "2024-02-22",
            "2024-02-23",
            "2024-02-24",
            "2024-02-25",
            "2024-02-26",
            "2024-02-27",
            "2024-02-28",
            "2024-02-29",
            "2024-03-01",
            "2024-03-02",
            "2024-03-03",
            "2024-03-04"
        ]
    }
}